xxxxxxxxxxxxxxxxxxxxxxxx
x0000xx000000000000000xx
x0000xx0000000000000000x
x0000000002000000000000x
xxxxx000000000000000000x
x0000000020000002000000x
x00000000000000000000xxx
x00x0000001000000000000x
x0xxx000000000000000000x
xxxxxxxxxxxxxxxxxxxxxxxx
